8
###################
#_______#####___###
#_#####_#####_#__##
#_##____#####_##__#
#_##_########_###_#
#_##_########_###_#
#_##_########_###_#
#_##________#_###_#
#_########_##_###_#
#____##____##_###_#
####_##_#####_###_#
#____##________##_#
#__################